00002000:-#-----!s=15;        # Section 1 : Intro
00002550:-----#-;
00002950:#--#---;
00003550:--#----;
00004050:------#;
00004550:----#--;
00004950:-#----#;
00005510:#--#---;
00005775:--#--#-;
00006000:------#;
00006500:----#--;
00006900:-#-#---;
00007500:----#--;
00007975:-#-----;
00008450:#------;
00008875:--#--#-;
00009450:---#--#;
00009700:#---#--;
00009950:--#----;
00010450:------#;
00010850:-#--#--;
00011400:--#----;
00011900:----#--;
00012400:------#;
00012800:#----#-;
00013400:-#-#---;
00013650:--#---#;
00013875:----#--;
00014350:#------;
00014775:-#-#---;
00015350:-----#-;
00015850:-#-----;
00016350:---#---;
00016750:--#---#;
00017300:---#-#-;
00017550:#--#---!s=20;
00017800:--#----;        # Section 2
00018300:----#--;
00018550:------#;
00018950:-#-----;
00019500:-----#-;
00019800:--#----;
00020200:---#---;
00020450:#------;
00020650:----#--;
00020900:------#;
00021250:-#-----;
00021500:%%---%%;
00021700:---#---;
00022150:--#----;
00022400:-----#-;
00022600:#------;
00022900:----#--;
00023200:-#-----;
00023700:------#;
00024100:--#----;
00024350:---#---;
00024600:-----#-;
00024850:#------;
00025200:----#--;
00025450:%%%---%;;